001111111000
011111111110
111111111110
011111111110
111111111110
111111111111
111111111110
111111111111
111111111110
011111111110
111111111110
011111111110
001111111000